register.eclipse	0
tmccrary	0
michael_case	romacafe
konstantin.komissarchik	kkomissarchik
mauromol	mauromol
p.rader	0
carmi	0
kdevolder	0
clovis.seragiotto	0
sxenos	sxenos
qudus	0
mateusz.matela	mateusz-matela
johan.spade	0
akarypid	0
matameko	0
sebastian.millies	smillies
baochlin	0
jmhenaff	0
pbielicki	pbielicki
ket1999	0
barney2k7	barney2k7
timo.kinnunen	Overruler
marco	0
sasikanth.bharadwaj	0
sebastian.zarnekow	szarnekow
garret	0
sam	0
dennis.huebner	dhuebner
fuzebest	0
awang060843	0
jan.hoppe	0
sarika.sinha	SarikaSinha
shankhba	0
snorthov	0
mcr	0
mistria	mickaelistria
anchakrk	0
igal	0
tom.schindl	tomsontom
nikolaymetchev	NikolayMetchev
